1111111111,1111111111,1111111111,1111111111,1111111111,1111111111,1111111111,1111111111,1111111111,1111111111
1111111111,1111111111,1111111111,1111111111,1111111111,1111111111,1111111111,1111111111,1111111111,1111111111
1111111111,1111111111,1111111111,1111111111,1111111111,1111111111,1111111111,1111111111,1111111111,1111111111
1111111111,1111111111,1111111111,1111111111,1111111111,1111111111,1111111111,1111111111,1111111111,1111111111
1111111111,1111111111,1111111111,1111111111,1111111111,1111111111,1111111111,1111111111,1111111111,1111111111
1111111111,1111111111,1111111111,1111111111,1111111111,1111111111,1111111111,1111111111,1111111111,1111111111
1111111111,1111111111,1111111111,1111111111,1111111111,1111111111,1111111111,1111111111,1111111111,1111111111
1111111111,1111111111,1111111111,1111111111,1111111111,1111111111,1111111111,1111111111,1111111111,1111111111
1111111111,1111111111,1111111111,1111111111,1111111111,1111111111,1111111111,1111111111,1111111111,1111111111
1111111111,1111111111,1111111111,1111111111,1111111111,1111111111,1111111111,1111111111,1111111111,1111111111
1111111111,1111111111,1111111111,1111111111,1111111111,1111111111,1111111111,1111111111,1111111111,1111111111
1111110000,0000000000,0000000000,0000000011,1111111111,1100000000,0000000000,0000000000,0000000011,1111111111
1111110000,0000000000,0000000000,0000000011,1111111111,1100000000,0000000000,0000000000,0000000011,1111111111
1111110000,0000000000,0000000000,0000000011,1111111111,1100000000,0000000000,0000000000,0000000011,1111111111
1111110000,0000000000,0000000000,0000000011,1111111111,1100000000,0000000000,0000000000,0000000011,1111111111
1111110000,0000000000,0000000000,0000000011,1111111111,1100000000,0000000000,0000000000,0000000011,1111111111
1111110000,0000000000,0000000000,0000000011,1111111111,1100000000,0000000000,0000000000,0000000011,1111111111
1111110000,0011111111,1111111111,1110000011,1111111111,1100000011,1111111111,1111111111,1110000011,1111111111
1111110000,0011111111,1111111111,1110000011,1111111111,1100000011,1111111111,1111111111,1110000011,1111111111
1111110000,0011111111,1111111111,1110000011,1111111111,1100000011,1111111111,1111111111,1110000011,1111111111
1111110000,0011111111,1111111111,1110000011,1111111111,1100000011,1111111111,1111111111,1110000011,1111111111
1111110000,0011111111,1111111111,1110000011,1111111111,1100000011,1111111111,1111111111,1110000011,1111111111
1111110000,0011111111,1111111111,1110000011,1111111111,1100000011,1111111111,1111111111,1110000011,1111111111
1111110000,0011111111,1111111111,1110000011,1111111111,1100000011,1111111111,1111111111,1110000011,1111111111
1111110000,0011111111,1111111111,1110000011,1111111111,1100000011,1111111111,1111111111,1110000011,1111111111
1111110000,0011111111,1111111111,1110000011,1111111111,1100000011,1111111111,1111111111,1110000011,1111111111
1111110000,0011111111,1111111111,1110000011,1111111111,1100000011,1111111111,1111111111,1110000011,1111111111
1111110000,0011111111,1111111111,1110000011,1111111111,1100000011,1111111111,1111111111,1110000011,1111111111
1111110000,0011111111,1111111111,1110000011,1111111111,1100000011,1111111111,1111111111,1110000011,1111111111
1111110000,0000000000,0000000000,0000000011,1111111111,1100000011,1111111111,1111111111,1110000011,1111111111
1111110000,0000000000,0000000000,0000000011,1111111111,1100000000,0000000000,0000000000,0000000011,1111111111
1111110000,0000000000,0000000000,0000000011,1111111111,1100000000,0000000000,0000000000,0000000011,1111111111
1111110000,0000000000,0000000000,0000000011,1111111111,1100000000,0000000000,0000000000,0000000011,1111111111
1111110000,0000000000,0000000000,0000000011,1111111111,1100000000,0000000000,0000000000,0000000011,1111111111
1111110000,0000000000,0000000000,0000000011,1111111111,1100000000,0000000000,0000000000,0000000011,1111111111
1111110000,0011111111,1111111111,1110000011,1111111111,1100000011,1111111100,0000000000,0000000011,1111111111
1111110000,0011111111,1111111111,1110000011,1111111111,1100000011,1111111100,0000111111,1111111111,1111111111
1111110000,0011111111,1111111111,1110000011,1111111111,1100000011,1111111100,0000111111,1111111111,1111111111
1111110000,0011111111,1111111111,1110000011,1111111111,1100000011,1111111100,0000111111,1111111111,1111111111
1111110000,0011111111,1111111111,1110000011,1111111111,1100000011,1111111100,0000111111,1111111111,1111111111
1111110000,0011111111,1111111111,1110000011,1111111111,1100000011,1111111100,0000111111,1111111111,1111111111
1111110000,0011111111,1111111111,1110000011,1111111111,1100000011,1111111100,0000111111,1111111111,1111111111
1111110000,0011111111,1111111111,1110000011,1111111111,1100000011,1111111100,0000111111,1111111111,1111111111
1111110000,0011111111,1111111111,1110000011,1111111111,1100000011,1111111100,0000111111,1111111111,1111111111
1111110000,0011111111,1111111111,1110000000,0000000000,0000000000,1111111100,0000111111,1111111111,1111111111
1111110000,0011111111,1111111111,1110000000,0000000000,0000000000,1111111100,0000111111,1111111111,1111111111
1111110000,0011111111,1111111111,1110000000,0000000000,0000000000,1111111100,0000000000,0000000000,0000111111
1111110000,0011111111,1111111111,1110000000,0000000000,0000000000,1111111100,0000000000,0000000000,0000111111
1111110000,0011111111,1111111111,1110000000,0000000000,0000000000,1111111100,0000000000,0000000000,0000111111
1111110000,0011111111,1111111111,1111111111,1111111111,1100000011,1111111100,0000000000,0000000000,0000111111
1111110000,0011111111,1111111111,1111111111,1111111111,1100000011,1111111100,0000000000,0000000000,0000111111
1111110000,0011111111,1111111111,1111111111,1111111111,1100000011,1111111100,0000000000,0000000000,0000111111
1111110000,0000000000,0000000000,0000000000,0000000000,0002000011,1111111100,0000000000,0000000000,0000111111
1111110000,0000000000,0000000000,0000000000,0000000000,0000000011,1111111100,0000000000,0000000000,0000111111
1111110000,0000000000,0000000000,0000000000,0000000000,0000000011,1111111100,0000000000,0000000000,0000111111
1111110000,0000000000,0000000000,0000000000,0000000000,0000000011,1111111100,0000000000,0000000000,0000111111
1111110000,0000000000,0000000000,0000000000,0000000000,0000000011,1111111100,0000000000,0000000000,0000111111
1111110000,0000000000,0000000000,0000000000,0000000000,0000000011,1111111100,0000000000,0000000000,0000111111
1111110000,0000000000,0000000000,0000000000,0000000000,0000000011,1111111100,0000000000,0000000000,0000111111
1111111111,1111111111,1111111111,1111111111,1111111111,1111111111,1111111111,1111111111,1111111111,1111111111
